19 23
WWWWWWWWWWWWWWWWWWW
W........W........W
WOWW.WWW.W.WWW.WWOW
W.WW.WWW.W.WWW.WW.W
W.................W
W.WW.W.WWWWW.W.WW.W
W....W...W...W....W
WWWW.WWW W WWW.WWWW
   W.W       W.W   
WWWW.W WWDWW W.WWWW
T   .  WGGGW  .   T
WWWW.W WWWWW W.WWWW
   W.W       W.W   
WWWW.W WWWWW W.WWWW
W........W........W
W.WW.WWW.W.WWW.WW.W
WO.W.....P.....W.OW
WW.W.W.WWWWW.W.W.WW
W....W...W...W....W
W.WWWWWW.W.WWWWWW.W
W.................W
WWWWWWWWWWWWWWWWWWW